Test
15
15
2,2,2,2,2,2,2,2,2,2,2,2,2,2,2
0,3,3,3,2,4,4,4,4,2,2,3,3,3,2
2,3,2,3,2,2,3,2,2,2,2,3,3,3,2
2,3,2,3,3,3,3,3,3,2,2,3,3,3,2
2,3,2,3,2,2,2,3,3,2,2,3,3,3,2
2,3,2,3,2,6,2,3,3,2,2,3,3,3,2
2,3,2,6,2,3,2,3,3,2,2,3,3,3,2
2,3,2,2,2,3,2,2,3,2,2,3,3,3,2
2,3,3,3,3,3,3,3,3,3,3,3,3,3,1
2,3,2,2,2,2,2,2,2,2,2,3,3,3,2
2,3,3,3,3,3,3,3,3,2,2,3,3,3,2
2,3,3,3,3,3,3,3,3,2,2,3,3,3,2
2,3,3,3,3,3,3,3,3,2,2,3,3,3,2
2,3,3,3,3,3,3,3,3,2,2,3,3,3,2
2,2,2,2,2,2,2,2,2,2,2,2,2,2,2
