Nivel2
30
15
2,2,2,2,2,2,2,2,2,2,2,2,2,2,2,2,2,2,2,2,2,2,2,2,2,2,2,2,2,2
0,3,3,2,2,2,3,3,3,3,3,3,3,3,2,2,2,2,2,3,2,2,3,2,3,2,3,3,3,2
2,2,3,2,3,3,3,2,3,2,2,3,2,3,2,3,2,3,3,3,3,2,3,2,3,2,2,2,3,2
2,2,3,2,3,2,3,2,3,2,2,3,2,3,2,3,2,3,2,2,3,2,3,3,3,2,3,3,3,2
2,3,3,3,3,2,3,2,3,2,3,3,2,3,2,3,3,3,2,3,3,2,3,2,2,2,3,2,3,2
2,2,3,2,2,2,3,2,3,2,3,2,2,3,2,2,2,3,2,2,3,3,3,3,3,3,3,2,3,2
2,2,3,3,3,3,3,3,3,2,3,3,2,3,2,2,2,3,2,2,2,2,3,2,2,2,2,2,2,2
2,3,3,2,2,2,2,3,2,2,2,3,2,3,2,3,3,3,3,3,3,2,3,2,3,3,3,3,3,2
2,3,2,3,3,3,2,3,2,3,2,2,2,3,2,3,2,3,2,2,3,2,3,3,2,3,2,2,3,2
2,3,2,2,2,3,3,3,2,3,2,3,3,3,2,3,2,3,2,3,3,2,3,2,2,3,2,2,3,2
2,3,3,3,3,2,2,3,2,3,3,3,2,2,2,3,2,3,2,2,3,2,3,3,3,3,2,2,3,2
2,2,3,2,3,2,2,3,2,2,2,3,3,3,2,3,2,3,3,3,3,2,2,2,2,3,2,2,3,2
2,3,3,3,3,2,3,3,3,3,3,2,2,3,2,2,2,3,2,2,2,2,3,3,3,3,3,2,3,2
2,3,2,3,2,2,3,2,2,2,3,2,2,3,3,3,3,3,2,3,3,3,3,2,2,2,2,2,3,2
2,2,2,2,2,2,2,2,2,2,2,2,2,2,2,2,2,2,2,2,2,2,2,2,2,2,2,2,1,2