Nivel3
30
30
2,2,2,2,2,2,2,2,2,2,2,2,2,2,2,2,2,2,2,2,2,2,2,2,2,2,2,2,2,2
0,3,3,2,2,2,3,3,3,3,3,3,3,3,2,2,2,2,2,3,2,2,3,2,3,2,3,3,3,2
2,2,3,2,3,3,3,2,3,2,2,3,2,3,2,3,2,3,3,3,3,2,3,2,3,2,2,2,3,2
2,2,3,2,3,2,3,2,3,2,2,3,2,3,2,3,2,3,2,2,3,2,3,3,3,2,3,3,3,2
2,3,3,3,3,2,3,2,3,2,3,3,2,3,2,3,3,3,2,3,3,2,3,2,2,2,3,2,3,2
2,2,3,2,2,2,3,2,3,2,3,2,2,3,2,2,2,3,2,2,3,3,3,3,3,3,3,2,3,2
2,2,3,3,3,3,3,3,3,2,3,3,2,3,2,2,2,3,2,2,2,2,3,2,2,2,2,2,2,2
2,3,3,2,2,2,2,3,2,2,2,3,2,3,2,3,3,3,3,3,3,2,3,2,3,3,3,3,3,2
2,3,2,3,3,3,2,3,2,3,2,2,2,3,2,3,2,3,2,2,3,2,3,3,2,3,2,2,3,2
2,3,2,2,2,3,3,3,2,3,2,3,3,3,2,3,2,3,2,3,3,2,3,2,2,3,2,2,3,2
2,3,3,3,3,2,2,3,2,3,3,3,2,2,2,3,2,3,2,2,3,2,3,3,3,3,2,2,3,2
2,2,3,2,3,2,2,3,2,2,2,3,3,3,2,3,2,3,3,3,3,2,2,2,2,3,2,2,3,2
2,3,3,3,3,2,3,3,3,3,3,2,2,3,2,2,2,3,2,2,2,2,3,3,3,3,3,2,3,2
2,3,2,3,2,2,3,2,2,2,3,2,2,3,3,3,3,3,2,3,3,3,3,2,2,2,2,2,3,2
2,2,3,3,2,2,2,2,2,3,3,2,2,2,2,2,2,2,2,3,2,2,2,2,2,2,2,2,3,2
2,2,3,2,2,2,2,2,2,3,2,3,3,2,2,2,2,2,2,3,2,3,3,3,3,3,3,3,3,2
2,3,3,3,3,3,2,2,2,3,2,2,3,3,3,3,3,3,3,3,3,3,2,2,3,2,2,2,3,2
2,2,3,2,2,3,2,2,2,3,2,2,2,3,2,2,2,2,2,2,2,2,2,2,3,2,3,2,3,2
2,2,2,2,2,3,2,2,2,3,2,2,2,3,2,3,3,2,3,3,3,3,3,3,3,2,3,3,3,2
2,3,3,3,3,3,3,3,3,3,3,3,3,3,2,2,3,3,3,2,2,2,2,2,3,2,2,2,2,2
2,3,2,3,2,3,2,2,3,2,2,2,2,2,2,2,2,2,3,3,3,3,3,2,3,3,3,3,3,2
2,3,3,3,2,3,3,3,3,2,3,3,3,3,3,3,3,2,3,2,2,2,3,2,3,2,2,2,3,2
2,2,2,2,2,3,2,2,3,2,3,2,2,3,2,2,3,2,3,3,3,2,3,3,3,3,3,3,3,2
2,3,3,3,3,3,3,3,3,2,2,2,2,3,2,2,3,2,2,2,2,2,2,2,2,2,2,2,3,2
2,2,2,2,2,2,2,2,2,2,2,2,2,3,2,2,3,2,2,3,3,3,3,3,3,3,3,3,3,2
2,2,2,2,2,2,2,2,3,3,3,3,3,3,2,3,3,2,2,2,3,2,2,2,3,2,2,2,3,2
2,3,3,3,3,3,3,2,3,2,2,2,2,2,2,3,2,3,3,3,3,2,2,2,3,2,2,2,3,2
2,3,2,2,2,3,3,3,3,3,3,3,3,2,2,3,2,3,2,2,2,2,2,2,3,2,3,3,3,2
2,3,2,2,2,3,2,2,3,2,2,2,3,2,2,3,3,3,3,3,3,3,3,3,3,3,3,2,3,2
2,1,2,2,2,2,2,2,2,2,2,2,2,2,2,2,2,2,2,2,2,2,2,2,2,2,2,2,2,2






































































